[
  [ 1, 2, 2, 2, 2, 2, 2, 2, 2, 2, 2, 2, 2, 2, 2, 2, 2, 2, 2, 3],
  [ 4, 0, 0, 0, 0, 0, 0, 0, 0, 0, 0, 0, 0, 0, 0, 0, 0, 0, 0, 6],
  [ 4, 0, -1, 0, 0, 7, 9,10, 0, 0, 0, 0, 0, 7, 9,10, 0, -3, 0, 6],
  [ 4, 0, 0, 0, 0,11,13,14, 0, 0, 0, 0, 0,11,13,14, 0, 0, 0, 6],
  [ 4, 0, 0, 0, 0, 0, 0, 0, 0, 0, 0, 0, 0, 0, 0, 0, 0, 0, 0, 6],
  [ 4, 0, 7, 8, 9,10, 0,18,19, 7, 9,10,18,19, 0, 0, 7, 9,10, 6],
  [ 4, 0,27,25,28,21, 0,20,21,27,28,21,20,21, 0, 7,24,28,21, 6],
  [ 4, 0,11,26,28,21, 0,20,21,27,28,21,20,21, 0,27,25,28,21, 6],
  [ 4, 0, 0,11,13,14, 0,22,23,11,13,14,22,23, 0,11,12,13,14, 6],
  [ 4, 0, 0, 0, 0, 0, 0, 0, 0, 0, 0, 0, 0, 0, 0, 0, 0, 0, 0, 6],
  [ 4, 0, 0, 0, 0, 7, 9,10, 0, 0, 0, 0, 0, 7, 9,10, 0, 0, 0, 6],
  [ 4, 0, 0, 0, 0,11,13,14, 0, 0, 0, 0, 0,11,13,14, 0, 0, 0, 6],
  [ 4, 0, -4, 0, 0, 0, 0, 0, 0, 0, 0, 0, 0, 0, 0, 0, 0, -2, 0, 6],
  [ 4, 0, 0, 0, 0, 0, 0, 0, 0, 0, 0, 0, 0, 0, 0, 0, 0, 0, 0, 6],
  [15,16,16,16,16,16,16,16,16,16,16,16,16,16,16,16,16,16,16,17]
]
