[
  [ 1, 2, 2, 2, 2, 2, 2, 2, 2, 2, 2, 2, 2, 2, 2, 2, 2, 2, 2, 3],
  [ 4, 5, 5, 5, 5, 5, 5, 5, 5, 5, 5, 5, 5, 5, 5, 5, 5, 5, 5, 6],
  [ 4, 5, 5, 5, 5, 7, 9,10, 5, 5, 5, 5, 5, 7, 9,10, 5, 5, 5, 6],
  [ 4, 5, 5, 5, 5,11,13,14, 5, 5, 5, 5, 5,11,13,14, 5, 5, 5, 6],
  [ 4, 5, 5, 5, 5, 5, 5, 5, 5, 5, 5, 5, 5, 5, 5, 5, 5, 5, 5, 6],
  [ 4, 5, 7, 8, 9,10, 5,18,19, 7, 9,10,18,19, 5, 5, 7, 9,10, 6],
  [ 4, 5,27,25,28,21, 5,20,21,27,28,21,20,21, 5, 7,24,28,21, 6],
  [ 4, 5,11,26,28,21, 5,20,21,27,28,21,20,21, 5,27,25,28,21, 6],
  [ 4, 5, 5,11,13,14, 5,22,23,11,13,14,22,23, 5,11,12,13,14, 6],
  [ 4, 5, 5, 5, 5, 5, 5, 5, 5, 5, 5, 5, 5, 5, 5, 5, 5, 5, 5, 6],
  [ 4, 5, 5, 5, 5, 7, 9,10, 5, 5, 5, 5, 5, 7, 9,10, 5, 5, 5, 6],
  [ 4, 5, 5, 5, 5,11,13,14, 5, 5, 5, 5, 5,11,13,14, 5, 5, 5, 6],
  [ 4, 5, 5, 5, 5, 5, 5, 5, 5, 5, 5, 5, 5, 5, 5, 5, 5, 5, 5, 6],
  [ 4, 5, 5, 5, 5, 5, 5, 5, 5, 5, 5, 5, 5, 5, 5, 5, 5, 5, 5, 6],
  [15,16,16,16,16,16,16,16,16,16,16,16,16,16,16,16,16,16,16,17]
]
